2 13 31
###############################
#p * *2       *  ** * *   3  *#
# # # # #*# # #*# # # # # #*# #
#    * * *** **      *    **  #
# #*# # # # # # #b# # # # # #*#
#        1 *     **1     *  **#
# # #*# # # # # #*#*#*#*# # # #
#   *        *   * *x* *      #
# # # # #*# # # # # # #*# #*# #
#   ****         *3           #
# # # # # # # # # #*# # # # #*#
#  ** *   *                  4#
###############################